{
	"lobby" : [
		"#############..#############",
		"#############..#############",
		"##lo........l..l........ol##",
		"##........................##",
		"##..........l..l..........##",
		"##........................##",
		"##l@..l.l..@l..l@..l.l..@l##",
		"............................",
		"............................",
		"##l@..l.l..@l..l@..l.l..@l##",
		"##........................##",
		"##..........l..l..........##",
		"##........................##",
		"##lo........l..l........ol##",
		"#############..#############",
		"#############..#############"
	],
	"0" : [
		"#############..#############",
		"#############..#############",
		"##.........l....l.........##",
		"##@..................X...@##",
		"##...@@@............@@@...##",
		"##........................##",
		"##..l......@@@@@@......l..##",
		"..........@.X..@@...........",
		"..........@....@.........@..",
		"##..l.....@....@.......l..##",
		"##........................##",
		"##...@@@............@@@...##",
		"##@....X.................@##",
		"##.........l....l.........##",
		"#############..#############",
		"#############..#############"
	],
	"1" : [
		"#############..#############",
		"#############..#############",
		"##........................##",
		"##....o.....####...o###...##",
		"##....##....####....###...##",
		"##....##...@####.@........##",
		"##....l..............l....##",
		".............X..............",
		"..........X.....X...........",
		"##....lo.......@.....l....##",
		"##.....######.......##....##",
		"##.....######......@##....##",
		"##.........##.......##o...##",
		"##.@......o##.............##",
		"#############..#############",
		"#############..#############"
	],
	"2" : [
		"#############..#############",
		"#############..#############",
		"####o...........X.......o###",
		"##.X..######...l.l..##...@##",
		"##....######.......@##....##",
		"##..####@......#########..##",
		"##..####...l...#########..##",
		"............................",
		"............................",
		"##..#########..#########..##",
		"##..#########..#########..##",
		"##..l.....o##..##....o##..##",
		"##.....X...##.........@X..##",
		"###@.....@.##.............##",
		"#############..#############",
		"#############..#############"
	],
	"3" : [
		"#############..#############",
		"#############..#############",
		"##........................##",
		"##.X....................X.##",
		"##........................##",
		"##........................##",
		"##........................##",
		"............................",
		"............................",
		"##........................##",
		"##........................##",
		"##........................##",
		"##.X....................X.##",
		"##........................##",
		"#############..#############",
		"#############..#############"
	],
	"4" : [
		"#############..#############",
		"#############..#############",
		"##@X..ol..l##..##.X...@..@##",
		"##........@##..##........o##",
		"##.........##..######..#####",
		"##..##.....##..######..#####",
		"##..##l@...##..##l@......l##",
		"....#####...................",
		"....#####...................",
		"##..##.....######...########",
		"##..##.....######...########",
		"##..##..#####.......##X..@##",
		"##......#####.......ol....##",
		"##X.......o##............@##",
		"#############..#############",
		"#############..#############"
	],
	"5" : [
		"#############..#############",
		"#############..#############",
		"##........................##",
		"##..####....##..###.......##",
		"##..####X...##..###...##..##",
		"##..##................##..##",
		"##..##...l.o..o..l.X..##..##",
		"....########..##########....",
		"....########..##########....",
		"##..##.X......##..X..@##..##",
		"##..##........##....####..##",
		"##..##.............l####..##",
		"##...o...l....@........o..##",
		"##..........@...l...@.....##",
		"#############..#############",
		"#############..#############"
	],
	"6" : [
		"#############..#############",
		"#############..#############",
		"##........................##",
		"##........................##",
		"##..####################..##",
		"##..####################..##",
		"##..##l....@l..loX...l##..##",
		"....##@....X.........O##....",
		"....##.....##..##.X...##....",
		"##..##l@X..##..##@...l##..##",
		"##..#########..#########..##",
		"##..#########..#########..##",
		"##........................##",
		"##........................##",
		"#############..#############",
		"#############..#############"
	],
	"7" : [
		"#############..#############",
		"#############..#############",
		"##@...o........l.@....@..l##",
		"##.......@..........X.....##",
		"##......................ol##",
		"##...#######################",
		"##o..#######################",
		".......@....X..........@....",
		"................ol..........",
		"#######################...##",
		"#######################...##",
		"##lo.............@..o.....##",
		"##.X......................##",
		"##l...@.@...l.....O.....@..##",
		"#############..#############",
		"#############..#############"
	],
	"8" : [
		"#############..#############",
		"#############..#############",
		"##.......@.##..##@.X....o.##",
		"##.X.......##..##.....@...##",
		"##o............o..........##",
		"#########@.........#########",
		"#########...l..l...#########",
		"............o........@......",
		"...o..........@.........@...",
		"#########...l..l...#########",
		"#########.@........#########",
		"##.....@.......@.........@##",
		"##X........##..##@...X....##",
		"##@..@....o##..##......o..##",
		"#############..#############",
		"#############..#############"
	],
	"9" : [
		"#############..#############",
		"#############..#############",
		"##X.....@..........X...@lo##",
		"##o...................X...##",
		"##....l......##...l##.....##",
		"##...######..#########...@##",
		"##...######..#########....##",
		".........##.........l.......",
		"......X..##......X..........",
		"##.......##....###...###..##",
		"##@..########..###...###..##",
		"##...########..###...###..##",
		"##........@##..........l..##",
		"##l..X.....##....@...X....##",
		"#############..#############",
		"#############..#############"
	],
	"10" : [
		"#############..#############",
		"#############..#############",
		"##l...l..o@.............ol##",
		"##..@.............l@......##",
		"##..########l..l########..##",
		"##..########.X..########..##",
		"##.@##..#####.@####.@###..##",
		".......X..########o.........",
		".....o...l########.X.l......",
		"##..##.o#####o.####..###..##",
		"##@.########.X..########.o##",
		"##..########l..l########..##",
		"##......o@...........@....##",
		"##l.........@...o.......@l##",
		"#############..#############",
		"#############..#############"
	],
	"11" : [
		"#############..#############",
		"#############..#############",
		"##.....##o.........l##...o##",
		"##..X.l##.......@...##.X..##",
		"##....###..####...X.##l..l##",
		"##....###..####.....@.....##",
		"##@.........@##l..........##",
		"......@......####...##@.....",
		"......##l.X..####...##......",
		"##....##.....lo....l##....##",
		"##l................###....##",
		"##....@...##...@...###....##",
		"##.@.X....##...........X.o##",
		"##......ol##@.....o......@##",
		"#############..#############",
		"#############..#############"
	],
	"12" : [
		"#############..#############",
		"#############..#############",
		"##@..###lo..........@l...o##",
		"##.X...........@........X.##",
		"##.....@.......#####o.....##",
		"##@..###..o#########......##",
		"##..o###...##########...@l##",
		".....###..X.....l####@......",
		".....###lo...X....####l.....",
		"##..@########.....####o...##",
		"##...########o....l###....##",
		"##.....l..@........###l..@##",
		"##.................@..X...##",
		"##l.o....@.......l......o.##",
		"#############..#############",
		"#############..#############"
	],
	"13" : [
		"#############..#############",
		"#############..#############",
		"##..l..@...ol...##@o....@l##",
		"##..............##...@....##",
		"##..lo.X..@....o##o....X..##",
		"##..##############.......@##",
		"##..##############lo......##",
		"........##......l...........",
		"........##o.X..........@....",
		"##l.....#####..#############",
		"##.....o#####..#############",
		"##........@........@....l@##",
		"##..X.@...............X...##",
		"##.@..@l..o....l.@.......0##",
		"#############..#############",
		"#############..#############"
	],
	"14" : [
		"#############..#############",
		"#############..#############",
		"####o....@.....##o.@......##",
		"#####.X.....l..##.....X..o##",
		"##@###...@@....###@.......##",
		"##..###o..o.....###.....@.##",
		"##...###....l..l@###l.....##",
		"......l..........ol.........",
		".........l...........lo.....",
		"##.....@###@l..l....###...##",
		"##.......###........@###..##",
		"##@......o###.........###o##",
		"##..X......##........X.#####",
		"##lo..@....##..l@..o....####",
		"#############..#############",
		"#############..#############"
	],
	"15" : [
		"#############..#############",
		"#############..#############",
		"##l....l...@l..lo...l.@o.l##",
		"##o.......@...............##",
		"##....X....##..##@...X....##",
		"##.@.......##..##........@##",
		"##l....l...@l..lo...lo...l##",
		"..................@.........",
		"........@...................",
		"##l...@l....l..l@...l..@.l##",
		"##.@.......##..##........o##",
		"##....X.o..##..##@...X....##",
		"##o..............o.......@##",
		"##l....l...ol..l....l....l##",
		"#############..#############",
		"#############..#############"
	]
}
